{
  "type": "grid",
  "width": 21,
  "height": 15,
  "allow_diagonal": false,
  "terrain_string": [
    "#####################",
    "#...................#",
    "#...................#",
    "#.###.####.#######..#",
    "#.........#.........#",
    "#.........#.........#",
    "#.........#.........#",
    "#...#################",
    "#.........#.........#",
    "#.........#.........#",
    "#...................#",
    "#.#########.........#",
    "#...................#",
    "#...................#",
    "#####################"
  ],
  "start": [
    1,
    1
  ],
  "goal": [
    19,
    13
  ],
  "expectations": {
    "reachable": true,
    "min_cost": 25.0,
    "max_cost": 40.0,
    "max_nodes_expanded": 500
  }
}